1111111111
1000000001
1200010101
1111010101
1200000101
1011111103
1000000001
1111111101
3100120001
1101001111
1000000301
1111111111